Adam West           	None
Alan Hewitt         	None
Andy Tennant        	6
Angie Dickinson     	1
Anjelica Huston     	4
Annette Andre       	None
Annette Funicello   	None
Billy Dee Williams  	None
Billy Gilbert       	None
Brad Pitt           	1
Burgess Meredith    	None
Burt Ward           	None
Buster Keaton       	None
Carl Reiner         	1
Carroll O'Connor    	None
Casey Affleck       	1
Cesar Romero        	None
Charles Bronson     	None
Charles Chaplin     	None
Charles Gray        	4
Charles Rogers      	None
Cheech Marin        	None
Christina Ricci     	3
Christopher Lloyd   	4
Clara Bow           	None
Clarence Muse       	None
Clint Eastwood      	None
Crispin Glover      	5
Darrow Igus         	None
David Naughton      	6
David Strathaim     	1
Deborah Walley      	None
Desmond Llewelyn    	5
Don Rickles         	None
Donald Sutherland   	None
Douglas Rain        	None
Eddie Albert        	6
Edgar Barrier       	7
Elizabeth Hurley    	None
Elliot Gould        	1
Emma Dunn           	None
Ernest Borgnine     	None
Fabian              	6
Frances Raymond     	None
Frank Gorshin       	None
Frank Langella      	1
Frank Webb          	None
Frankie Avalon      	None
Fred Gwynne         	None
Gary Lockwood       	None
Gavin MacLeod       	None
Geoffrey Palmer     	None
George Carlin       	None
George Clooney      	0
George Kennedy      	None
Glenne Headly       	None
Gwyneth Paltrow     	2
Harvey Clark        	None
Harvey Lembeck      	None
Henry Daniell       	None
Jack Gilford        	None
Jack LaLanne        	None
Jack Nicholson      	None
Jack Oakie          	None
Jack Palance        	None
James Spinks        	None
Jamie Lee Curtis    	None
Jason Bateman       	1
Jeanette Nolan      	7
Jeff Bridges        	2
Jennifer Lewis      	None
Jill St John        	5
Joe Flynn           	None
Joe Pesci           	None
John Cleese         	None
John Goodman        	2
Josef Swickard      	None
Josephine Dunn      	None
Julia Roberts       	1
Julianne Moore      	2
Keir Dullea         	None
Kevin Kline         	None
Kim Basinger        	None
Kurt Russell        	None
Lana Wood           	5
Lee Marvin          	None
Lee Meriwether      	None
Linda Evans         	None
Maria Atkin         	None
Marisa Tomei        	None
Meat Loaf           	4
Michael Caine       	None
Michael J Fox       	5
Michael Keaton      	None
Michael Palin       	None
Michael York        	None
Mike Myers          	None
Nicole Kidman       	None
Orson Welles        	7
Otis Day            	None
Owen Wilson         	None
Patricia Quinn      	4
Paul Anka           	6
Paul Lynde          	None
Paul Newman         	None
Paulette Goddard    	None
Peter Lawford       	6
Phil Silvers        	None
Ralph Macchio       	None
Raul Julia          	4
Richard Burton      	6
Richard O'Brien     	4
Richard Pryor       	None
Robert Downey Jr    	1
Robert Wagner       	None
Robert Wuhl         	None
Roddy McDowall      	6
Sam Elliott         	1
Sean Connery        	5
Seth Green          	None
Shirley MacLaine    	None
Steve Lawrence      	1
Steve Martin        	None
Susan Sarandon      	3
Telly Savalas       	None
Tim Curry           	4
Wayne Newton        	1
Will Ferrell        	None
William Sylvester   	None
Zero Mostel         	None
